S.........
##....##..
.####...##
..........
.......###
D.........
####...###
..........
#...#.###.
..........